#######################################
# Syntax Coloring Map For iLib
#######################################

#######################################
# Datatypes (KEYWORD1)
#######################################

#######################################
# Methods and Functions (KEYWORD2)
#######################################

spektrum_init	KEYWORD2
spektrum_send	KEYWORD2

ATMEL	KEYWORD1
readVcc	KEYWORD2

WirePlus	KEYWORD1
probe	KEYWORD2
probeAddress	KEYWORD2
write	KEYWORD2
writeByte	KEYWORD2
writeCMD	KEYWORD2
read	KEYWORD2
readByte	KEYWORD2
setRegister	KEYWORD2
getRegister	KEYWORD2

i2cSensor	KEYWORD1
setEnabled	KEYWORD2
reset	KEYWORD2
initialize	KEYWORD2
checkMeasurement	KEYWORD2
awaitMeasurement	KEYWORD2

manualSensor	KEYWORD1
triggerMeasurement	KEYWORD2

BMP280	KEYWORD1
getEnabled	KEYWORD2
setPressureOversampleRatio	KEYWORD2
setTemperatureOversampleRatio	KEYWORD2
setFilterRatio	KEYWORD2
setStandby	KEYWORD2
readTrimming	KEYWORD2
getPressure		KEYWORD2
getMeasurement		KEYWORD2
getAltitude		KEYWORD2
getTemperature	KEYWORD2


FAN5421	KEYWORD1
set_safety	KEYWORD2
poll_timer	KEYWORD2
print_status	KEYWORD2
print_register	KEYWORD2
set_config	KEYWORD2
set_current	KEYWORD2
increase_current	KEYWORD2
decrease_current	KEYWORD2
print_info	KEYWORD2
get_chargingstatus	KEYWORD2
charging_enable	KEYWORD2
power_without_battery	KEYWORD2


L3G	KEYWORD1
setDatarate	KEYWORD2
setSensibility	KEYWORD2


LPS331	KEYWORD1
setDatarate	KEYWORD2
setSensitivity	KEYWORD2
getTemperature	KEYWORD2
getAltitude	KEYWORD2


MAG3110	KEYWORD1
setSensorAutoReset	KEYWORD2
setRawMode	KEYWORD2
setDataRate	KEYWORD2


MAX17047	KEYWORD1
set_capacity_design	KEYWORD2
set_full_threshold	KEYWORD2
set_termination_charge_current	KEYWORD2
set_empty_voltage	KEYWORD2
set_alarm_voltage	KEYWORD2
backup_data	KEYWORD2
restore_data	KEYWORD2
set_config	KEYWORD2
print_status	KEYWORD2
get_cell_voltage	KEYWORD2
get_cell_current	KEYWORD2


MAX44009	KEYWORD1


MMA8451	KEYWORD1
setSensibility	KEYWORD2
setDatarate	KEYWORD2


MPL3115A2	KEYWORD1
setAltimeter	KEYWORD2
getEnabled	KEYWORD2
setOversampleRatio	KEYWORD2
setEventFlags	KEYWORD2
getAltitude	KEYWORD2
getPressure	KEYWORD2
getMeasurement	KEYWORD2
getTemperature	KEYWORD2


MPU9250	KEYWORD1
setGSensitivity	KEYWORD2
setASensitivity	KEYWORD2
setDatarate	KEYWORD2
setBandwidth	KEYWORD2


PCF2127	KEYWORD1
clearInterrupt	KEYWORD2
setTemperaturePeriod	KEYWORD2
setClockOut	KEYWORD2
setTime	KEYWORD2
readTime	KEYWORD2
setSeconds	KEYWORD2
getSeconds	KEYWORD2
setMinutes	KEYWORD2
getMinutes	KEYWORD2
setHours	KEYWORD2
getHours	KEYWORD2
setDays	KEYWORD2
getDays	KEYWORD2
setWeekdays	KEYWORD2
getWeekdays	KEYWORD2
setMonth	KEYWORD2
getMonth	KEYWORD2
setYears	KEYWORD2
getYears	KEYWORD2


SI7021	KEYWORD1
readValue	KEYWORD2
setResolution	KEYWORD2
setHeater	KEYWORD2
readHumidity	KEYWORD2
getHumidity	KEYWORD2
readTemperature	KEYWORD2
getTemperature	KEYWORD2
requestTemperature	KEYWORD2
readTemperatureReq	KEYWORD2
getTemperatureReq	KEYWORD2


TCS3772	KEYWORD1
ATIME_TO_MSEC	KEYWORD2
MSEC_TO_ATIME	KEYWORD2
FACT_TO_ATIME	KEYWORD2
MSEC_TO_ATIMELONG	KEYWORD2
setWaitTime	KEYWORD2
setATime	KEYWORD2
setAGain	KEYWORD2
autoGain	KEYWORD2


RFM95	KEYWORD1
spiExchange	KEYWORD2


WS2812B	KEYWORD1
setleds	KEYWORD2
setleds_pin	KEYWORD2
sendarray	KEYWORD2
sendarray_mask	KEYWORD2


#######################################
# Instances (KEYWORD2)
#######################################

#######################################
# Constants (LITERAL1)
#######################################
